2
# Items which can be obtained by simply using another item.  There are
# lots more of these, but this appears to be the only one that
# guarantees that each item drops exactly once.

tamarind-flavored chewing gum	SUSE	pack of chewing gum
lime-and-chile-flavored chewing gum	SUSE	pack of chewing gum
pickle-flavored chewing gum	SUSE	pack of chewing gum
jaba&ntilde;ero-flavored chewing gum	SUSE	pack of chewing gum

# Christmas-specific items which can be created through combination or
# smithing.

present	COMBINE	box	wrapping paper
bow staff	SMITH	big stick	bow
bowlegged pants	SMITH	pants kit	bow
bowler	SMITH	helmet recipe	bow
Crimbo hat	SMITH	wrapping paper	helmet recipe
Crimbo pants	SMITH	wrapping paper	pants kit
Crimbo sword	SMITH	wrapping paper	sword hilt
Tropical Crimbo Hat	SMITH	tropical wrapping paper	helmet recipe
Tropical Crimbo Shorts	SMITH	tropical wrapping paper	pants kit
Tropical Crimbo Sword	SMITH	tropical wrapping paper	sword hilt


# Quest items which are created by combination and their subparts.

abridged dictionary	COMBINE	bridge	dictionary
badass belt	COMBINE	batskin belt	dragonbone belt buckle
bitchin' meatcar	COMBINE	dope wheels	meat engine
bone rattle	COMBINE	skeleton bone	broken skull
Bonerdagon necklace	COMBINE	hemp string	vertebra of the Bonerdagon
cog and sprocket assembly	COMBINE	cog	sprocket assembly
dope wheels	COMBINE	tires	sweet rims
full meat tank	COMBINE	empty meat tank	meat stack
Harold's hammer	COMBINE	Harold's hammer head	Harold's hammer handle
headpiece of the Staff of Ed	COMBINE	ancient amulet	Eye of Ed
heavy metal sonata	COMBINE	chrome ore	drab sonata
heavy metal thunderrr guitarrr	COMBINE	acoustic guitarrr	chrome ore
hosed fishbowl	COMBINE	fishbowl	fish hose
hosed tank	COMBINE	fishtank	fish hose
imbued seal-blubber candle	COMBINE	powdered sealbone	seal-blubber candle
intragalactic rowboat	COMBINE	S.O.C.K.	quantum egg
makeshift SCUBA gear	COMBINE	hosed tank	fishbowl
Mighty Bjorn action figure	COMBINE	action figure head	action figure body
oyster basket	COMBINE	tisket	tasket
really really sticky spider web	COMBINE	really sticky spider web	really sticky spider web
really sticky spider web	COMBINE	spider web	spider web
skeleton key	COMBINE	skeleton bone	loose teeth
Staff of Ed	COMBINE	headpiece of the Staff of Ed	Staff of Fats
rusty metal key	COMBINE	rusty metal ring	rusty metal shaft
tambourine	COMBINE	Gnollish pie tin	tambourine bells
charged magnet	COMBINE	floaty sand	moxie magnet


# Items involved with the campground, or subcomponents involved in the
# creation of campground items.

barskin tent	COMBINE	bar skin	wooden stakes
beanbag chair	COMBINE	hill of beans	filthy knitted dread sack
cottage	COMBINE	anticheese	bowl of cottage cheese
evil golden arches	COMBINE	evil golden arch	evil golden arch
lifeless meat doll	COMBINE	meat face	wooden figurine
maid head	COMBINE	brainy skull	maiden wig
meat engine	COMBINE	full meat tank	cog and sprocket assembly
meat face	COMBINE	fairy gravy boat	dried face
meat golem	COMBINE	lifeless meat doll	magicalness-in-a-can
Meat maid	COMBINE	maid head	Meat maid body
Meat maid body	COMBINE	frilly skirt	meat engine
pretty bouquet	COMBINE	pretty flower	pretty flower
spooky scarecrow	COMBINE	wooden stakes	spooky staff


# Weapons and accessories that can be created by non-seal clubbers by
# combining items.

aerated diving helmet	COMBINE	bubblin' stone	rusty diving helmet
asshat	COMBINE	bum cheek	bum cheek
beach glass necklace	COMBINE	beach glass bead	hemp string
detective skull	COMBINE	gnoll lips	brainy skull
disembodied smile	COMBINE	gnoll lips	gnoll teeth
enchanted eyepatch	COMBINE	eyepatch	lihc eye
gnatwing earring	COMBINE	gnatwing	piercing post
Gnollish autoplunger	COMBINE	Gnollish plunger	meat engine
gnoll-tooth necklace	COMBINE	gnoll teeth	hemp string
peace-sign necklace	COMBINE	clay peace-sign bead	hemp string
phat turquoise bracelet	COMBINE	phat turquoise bead	hemp string
spooky staff	COMBINE	spooky shrunken head	spooky stick
Talisman o' Nam	COMBINE	snakehead charrrm	snakehead charrrm

boxing glove on a spring	COMBINE	nothing-in-the-box	boxing glove
grass whistle	COMBINE	leaf of grass	leaf of grass
office-supply crossbow	COMBINE	stolen office supplies	stolen office supplies
club of corruption	COMBINE	seal-clubbing club	tainted seal's blood
corrupt club of corruption	COMBINE	club of corruption	tainted seal's blood
corrupt club of corrupt corruption	COMBINE	corrupt club of corruption	tainted seal's blood

memory of a CA base pair	COMBINE	memory of a C	memory of an A
memory of a CG base pair	COMBINE	memory of a C	memory of a G
memory of a CT base pair	COMBINE	memory of a C	memory of a T
memory of an AG base pair	COMBINE	memory of an A	memory of a G
memory of an AT base pair	COMBINE	memory of an A	memory of a T
memory of a GT base pair	COMBINE	memory of a G	memory of a T


# Clover weapons and their subcomponents.  These can be made by all
# classes by meatsmithing

ten-leaf clover	SUSE	disassembled clover
disassembled clover	SUSE	ten-leaf clover

seal-toothed rock	SMITH	seal tooth	big rock
Bjorn's Hammer	SMITH	seal-toothed rock	seal-clubbing club
Hammer of Smiting	SMITH	Bjorn's Hammer	distilled seal blood

stone turtle	SMITH	chisel	big rock
Mace of the Tortoise	SMITH	stone turtle	turtle totem
Chelonian Morningstar	SMITH	Mace of the Tortoise	turtle chain

spaghetti with rock-balls	SMITH	petrified noodles	big rock
Pasta of Peril	SMITH	spaghetti with rock-balls	pasta spoon
Greek Pasta of Peril	SMITH	Pasta of Peril	high-octane olive oil

heavy hot sauce	SMITH	jaba&ntilde;ero pepper	big rock
5-Alarm Saucepan	SMITH	heavy hot sauce	saucepan
17-alarm Saucepan	SMITH	5-Alarm Saucepan	Peppercorns of Power

stone banjo	SMITH	banjo strings	big rock
Disco Banjo	SMITH	stone banjo	disco ball
Shagadelic Disco Banjo	SMITH	Disco Banjo	vial of mojo

heart of rock and roll	SMITH	hot buttered roll	big rock
Rock and Roll Legend	SMITH	heart of rock and roll	stolen accordion
Squeezebox of the Ages	SMITH	Rock and Roll Legend	golden reeds

dueling banjo	SMITH	dueling turtle	banjo strings

# Familiar items and their subcomponents which do not serve any other
# recalled purpose.

cocoa egg	COOK	large cocoa eggshell fragment	large cocoa eggshell fragment
fertilized ghuol egg	COMBINE	ghuol egg	Spooky-Gro fertilizer
goat	COMBINE	anticheese	goat cheese
hovering sombrero	COMBINE	irate sombrero	poultrygeist
large cocoa eggshell fragment	COOK	cocoa eggshell fragment	cocoa eggshell fragment
one-winged stab bat	COMBINE	batblade	bat wing
pirate skull	COMBINE	eyepatch	brainy skull
spooky pirate skeleton	SUSE	pirate skull	sunken chest	pirate pelvis	skeleton bone (8)
pregnant gloomy black mushroom	COOK	gloomy black mushroom	spooky fairy gravy
pregnant oily golden mushroom	COOK	oily golden mushroom	sleazy fairy gravy
pregnant mushroom	COOK	Knob mushroom	fairy gravy boat
rewinged stab bat	COMBINE	bat wing	one-winged stab bat
sabre-toothed lime cub	COMBINE	lime	sabre teeth
sleazy fairy gravy	COOK	pr0n legs	fairy gravy boat
ghost pickle on a stick	COOK	spectral pickle	skewer

clockwork pirate skull	COMBINE	clockwork sphere	enchanted eyepatch
pirate zombie head	COMBINE	clockwork pirate skull	zombie pineal gland
pirate zombie robot head	COMBINE	pirate zombie head	glowing red eye
ninja pirate zombie robot head	COMBINE	pirate zombie robot head	cold ninja mask

rock lobster	SUSE	wok lobster	floaty rock

wet stew	COOK	bird rib	lion oil
wet stunt nut stew	COOK	wet stew	stunt nuts

baneful bandolier	SMITH	caustic slime nodule	slime-covered necklace
bitter pill	COOK	caustic slime nodule	scrumptious reagent
corroded breeches	SMITH	caustic slime nodule	slime-covered greaves
corrosive cowl	SMITH	caustic slime nodule	slime-covered helmet
diabolical crossbow	SMITH	caustic slime nodule	slime-covered speargun
grisly shield	SMITH	caustic slime nodule	slime-covered lantern
malevolent medallion	SMITH	caustic slime nodule	slime-covered compass
pernicious cudgel	SMITH	caustic slime nodule	slime-covered club
villainous scythe	SMITH	caustic slime nodule	slime-covered shovel

# Box parts and things that go into boxes or become boxes or are involved
# in some way with boxes and the things that become/go into them.

bartender skull	COMBINE	brainy skull	beer goggles
bartender-in-the-box	COMBINE	bartender-skull-in-the-box	cocktailcrafting kit
bartender-skull-in-the-box	COMBINE	nothing-in-the-box	bartender skull
beer goggles	COMBINE	beer lens	beer lens
box-in-the-box	COMBINE	box	nothing-in-the-box
box-in-the-box-in-the-box	COMBINE	box	nothing-in-the-box-in-the-box
brainy skull	COMBINE	disembodied brain	smart skull
chef skull	COMBINE	brainy skull	chef's hat
chef-in-the-box	COMBINE	chef-skull-in-the-box	E-Z Cook Oven&trade;
chef-skull-in-the-box	COMBINE	nothing-in-the-box	chef skull
nothing-in-the-box	COMBINE	box	spring
nothing-in-the-box-in-the-box	COMBINE	box-in-the-box	spring
sprocket assembly	COMBINE	sprocket	spring
boxing glove on a spring	COMBINE	nothing-in-the-box	boxing glove
4-d camera	COMBINE	nothing-in-the-box	beer lens


# Items created by combining letters.

ND	COMBINE	lowercase N	heavy D
NG	COMBINE	lowercase N	original G
WA	COMBINE	metallic A	ruby W
Wand of Nagamar	COMBINE	WA	ND
wang	COMBINE	WA	NG


# Burritos, pizza and statue lime pies.  These are a class all their own
# because of their popularity.  Other really popular items, like spectral
# pickles, are also included.

banana cream pie	COOK	pie crust	banana
banana milkshake	COOK	glass of baboon milk	banana
banana spritzer	COOK	banana	soda water
bean burrito	COOK	flat dough	hill of beans
cherry pie	COOK	pie crust	cherry
cream pie	COOK	pie crust	glass of goat's milk
briny vinegar	COOK	brine	vinegar
enchanted bean burrito	COOK	flat dough	enchanted bean
flower petal pie	COOK	pretty flower	pie crust
ghostly pickling solution	COOK	briny vinegar	dill
goat cheese pizza	COOK	plain pizza	goat cheese
guano coffee cup	SUSE	bat guano
herb brownies	COOK	herbs	Uncle Jick's Brownie Mix
hippy herbal tea	COOK	guano coffee cup	herbs
insanely spicy bean burrito	COOK	spicy bean burrito	jaba&ntilde;ero pepper
insanely spicy enchanted bean burrito	COOK	spicy enchanted bean burrito	jaba&ntilde;ero pepper
insanely spicy jumping bean burrito	COOK	spicy jumping bean burrito	jaba&ntilde;ero pepper
jumping bean burrito	COOK	flat dough	pile of jumping beans
lemon meringue pie	COOK	pie crust	lemon
Lucky Surprise Egg	COOK	ten-leaf clover	cocoa egg
mushroom pizza	COOK	plain pizza	Knob mushroom
pie crust	COOK	Gnollish pie tin	wad of dough
plain pizza	COOK	wad of dough	tomato
rocky road ice cream	COOK	glass of goat's milk	floaty gravel
sausage pizza	COOK	plain pizza	Knob sausage
spicy bean burrito	COOK	bean burrito	spices
spicy enchanted bean burrito	COOK	enchanted bean burrito	spices
spicy jumping bean burrito	COOK	jumping bean burrito	spices
spectral pickle	COOK	ghost cucumber	ghostly pickling solution
Spooky Surprise Egg	COOK	spooky wad	cocoa egg
strawberry pie	COOK	pie crust	strawberry

Boris's key lime	COOK	Boris's key	lime
Boris's key lime pie	COOK	Boris's key lime	pie crust
digital key lime	COOK	digital key	lime
digital key lime pie	COOK	digital key lime	pie crust
Jarlsberg's key lime	COOK	Jarlsberg's key	lime
Jarlsberg's key lime pie	COOK	Jarlsberg's key lime	pie crust
Sneaky Pete's key lime	COOK	Sneaky Pete's key	lime
Sneaky Pete's key lime pie	COOK	Sneaky Pete's key lime	pie crust
star key lime	COOK	Richard's star key	lime
star key lime pie	COOK	star key lime	pie crust


# Items which can be created by using a rolling pin.

flat dough	ROLL	wad of dough
wad of dough	ROLL	flat dough


# Other recipes which aren't popular but can be created.  There is no
# real reason why they aren't popular - they just aren't.

bat haggis	COOK	batgut	spices
bat wing kabob	COOK	bat wing	skewer
brains casserole	COOK	fricasseed brains	Gnollish casserole dish
carob brownies	COOK	carob chunks	Uncle Jick's Brownie Mix
carob chunk cookies	COOK	carob chunks	wad of dough
catgut taco	COOK	catgut	taco shell
chorizo taco	COOK	uncooked chorizo	taco shell
ghuol egg quiche	COOK	ghuol egg	pie crust
ghuol-ear kabob	COOK	ghuol ears	skewer
goat cheese taco	COOK	goat cheese	taco shell
grue egg omelette	COOK	grue egg	spooky mushroom
hot stuffing	COOK	heavy hot sauce	stuffing
jumping bean taco	COOK	pile of jumping beans	taco shell
Knob shroomkabob	COOK	Knob mushroom	skewer
Knoll shroomkabob	COOK	Knoll mushroom	skewer
lihc eye pie	COOK	lihc eye	pie crust
menudo	COOK	catgut	spices
papaya taco	COOK	papaya	taco shell
pr0n cocktail	COOK	pr0n legs	ketchup
pr0n taco	COOK	pr0n legs	taco shell
rat appendix kabob	COOK	rat appendix	skewer
rat scrapple	COOK	ratgut	spices
royal jelly taco	COOK	royal jelly	taco shell
skewered cat appendix	COOK	cat appendix	skewer
spooky shroomkabob	COOK	spooky mushroom	skewer
stuffed spooky mushroom	COOK	spooky mushroom	goat cheese
tofu casserole	COOK	wad of tofu	Gnollish casserole dish
tofu taco	COOK	wad of tofu	taco shell
white chocolate chip cookies	COOK	white chocolate chips	wad of dough
white chocolate chip brownies	COOK	white chocolate chips	Uncle Jick's Brownie Mix


# Food requiring access to L11 or L12 quest areas

fishy fish	COOK	displaced fish	dehydrated caviar
fishy fish casserole	COOK	fishy fish	Gnollish casserole dish
gnatloaf	COOK	[2528]	ancient spice
gnatloaf casserole	COOK	gnatloaf	Gnollish casserole dish
long pork chop sandwiches	COOK	long pork	black pepper
long pork casserole	COOK	long pork chop sandwiches	Gnollish casserole dish

nutty organic salad	COOK	mixed wildflower greens	handful of walnuts
super salad	COOK	mixed wildflower greens	megatofu

beer basted brat	COOK	frat brats	McMillicancuddy's Special Lager
super ka-bob	COOK	frat brats	knob ka-bobs

Crimbo pie	COOK	pie crust	plum
pear tart	COOK	pie crust	pear
peach pie	COOK	pie crust	peach


# Sushi

beefy nigiri	SUSHI	beefy fish meat	white rice
glistening nigiri	SUSHI	glistening fish meat	white rice
slick nigiri	SUSHI	slick fish meat	white rice

beefy maki	SUSHI	beefy fish meat	white rice	seaweed
giant dragon roll	SUSHI	beefy fish meat	white rice	seaweed	sea cucumber
Jack LaLanne roll	SUSHI	beefy fish meat	white rice	seaweed	sea radish
musclebound rabbit roll	SUSHI	beefy fish meat	white rice	seaweed	sea carrot
python roll	SUSHI	beefy fish meat	white rice	seaweed	sea avocado

magical beefy maki	SUSHI	beefy fish meat	white rice	seaweed	dragonfish caviar
magical giant dragon roll	SUSHI	beefy fish meat	white rice	seaweed	sea cucumber	dragonfish caviar
magical Jack LaLanne roll	SUSHI	beefy fish meat	white rice	seaweed	sea radish	dragonfish caviar
magical musclebound rabbit roll	SUSHI	beefy fish meat	white rice	seaweed	sea carrot	dragonfish caviar
magical python roll	SUSHI	beefy fish meat	white rice	seaweed	sea avocado	dragonfish caviar

salty beefy maki	SUSHI	beefy fish meat	white rice	seaweed	sea salt crystal
salty giant dragon roll	SUSHI	beefy fish meat	white rice	seaweed	sea cucumber	sea salt crystal
salty Jack LaLanne roll	SUSHI	beefy fish meat	white rice	seaweed	sea radish	sea salt crystal
salty musclebound rabbit roll	SUSHI	beefy fish meat	white rice	seaweed	sea carrot	sea salt crystal
salty python roll	SUSHI	beefy fish meat	white rice	seaweed	sea avocado	sea salt crystal

electric beefy maki	SUSHI	beefy fish meat	white rice	seaweed	eel sauce
electric giant dragon roll	SUSHI	beefy fish meat	white rice	seaweed	sea cucumber	eel sauce
electric Jack LaLanne roll	SUSHI	beefy fish meat	white rice	seaweed	sea radish	eel sauce
electric musclebound rabbit roll	SUSHI	beefy fish meat	white rice	seaweed	sea carrot	eel sauce
electric python roll	SUSHI	beefy fish meat	white rice	seaweed	sea avocado	eel sauce

glistening maki	SUSHI	glistening fish meat	white rice	seaweed
wise dragon roll	SUSHI	glistening fish meat	white rice	seaweed	sea cucumber
wizened master roll	SUSHI	glistening fish meat	white rice	seaweed	sea radish
white rabbit roll	SUSHI	glistening fish meat	white rice	seaweed	sea carrot
ancient serpent roll	SUSHI	glistening fish meat	white rice	seaweed	sea avocado

magical glistening maki	SUSHI	glistening fish meat	white rice	seaweed	dragonfish caviar
magical wise dragon roll	SUSHI	glistening fish meat	white rice	seaweed	sea cucumber	dragonfish caviar
magical wizened master roll	SUSHI	glistening fish meat	white rice	seaweed	sea radish	dragonfish caviar
magical white rabbit roll	SUSHI	glistening fish meat	white rice	seaweed	sea carrot	dragonfish caviar
magical ancient serpent roll	SUSHI	glistening fish meat	white rice	seaweed	sea avocado	dragonfish caviar

salty glistening maki	SUSHI	glistening fish meat	white rice	seaweed	sea salt crystal
salty wise dragon roll	SUSHI	glistening fish meat	white rice	seaweed	sea cucumber	sea salt crystal
salty wizened master roll	SUSHI	glistening fish meat	white rice	seaweed	sea radish	sea salt crystal
salty white rabbit roll	SUSHI	glistening fish meat	white rice	seaweed	sea carrot	sea salt crystal
salty ancient serpent roll	SUSHI	glistening fish meat	white rice	seaweed	sea avocado	sea salt crystal

electric glistening maki	SUSHI	glistening fish meat	white rice	seaweed	eel sauce
electric wise dragon roll	SUSHI	glistening fish meat	white rice	seaweed	sea cucumber	eel sauce
electric wizened master roll	SUSHI	glistening fish meat	white rice	seaweed	sea radish	eel sauce
electric white rabbit roll	SUSHI	glistening fish meat	white rice	seaweed	sea carrot	eel sauce
electric ancient serpent roll	SUSHI	glistening fish meat	white rice	seaweed	sea avocado	eel sauce

slick maki	SUSHI	slick fish meat	white rice	seaweed
eleven oceans roll	SUSHI	slick fish meat	white rice	seaweed	sea radish
tricky dragon roll	SUSHI	slick fish meat	white rice	seaweed	sea cucumber
sneaky rabbit roll	SUSHI	slick fish meat	white rice	seaweed	sea carrot
slippery snake roll	SUSHI	slick fish meat	white rice	seaweed	sea avocado

magical slick maki	SUSHI	slick fish meat	white rice	seaweed	dragonfish caviar
magical eleven oceans roll	SUSHI	slick fish meat	white rice	seaweed	sea radish	dragonfish caviar
magical tricky dragon roll	SUSHI	slick fish meat	white rice	seaweed	sea cucumber	dragonfish caviar
magical sneaky rabbit roll	SUSHI	slick fish meat	white rice	seaweed	sea carrot	dragonfish caviar
magical slippery snake roll	SUSHI	slick fish meat	white rice	seaweed	sea avocado	dragonfish caviar

salty slick maki	SUSHI	slick fish meat	white rice	seaweed	sea salt crystal
salty eleven oceans roll	SUSHI	slick fish meat	white rice	seaweed	sea radish	sea salt crystal
salty tricky dragon roll	SUSHI	slick fish meat	white rice	seaweed	sea cucumber	sea salt crystal
salty sneaky rabbit roll	SUSHI	slick fish meat	white rice	seaweed	sea carrot	sea salt crystal
salty slippery snake roll	SUSHI	slick fish meat	white rice	seaweed	sea avocado	sea salt crystal

electric slick maki	SUSHI	slick fish meat	white rice	seaweed	eel sauce
electric eleven oceans roll	SUSHI	slick fish meat	white rice	seaweed	sea radish	eel sauce
electric tricky dragon roll	SUSHI	slick fish meat	white rice	seaweed	sea cucumber	eel sauce
electric sneaky rabbit roll	SUSHI	slick fish meat	white rice	seaweed	sea carrot	eel sauce
electric slippery snake roll	SUSHI	slick fish meat	white rice	seaweed	sea avocado	eel sauce

# Booze requiring access to L11 or L12 quest areas

shot of blackberry schnapps	MIX	fermenting powder	blackberry
boilermaker	MIX	McMillicancuddy's Special Lager	bottle of whiskey

plum wine	MIX	fermenting powder	plum
shot of pear schnapps	MIX	fermenting powder	pear
shot of peach schnapps	MIX	fermenting powder	peach

bottle of gin (3)	MIX	fermenting powder	juniper berries
bottle of rum (3)	MIX	fermenting powder	brown sugar cane
bottle of tequila (3)	MIX	fermenting powder	cactus fruit
bottle of vodka (3)	MIX	fermenting powder	bowl of rye sprouts
bottle of whiskey (3)	MIX	fermenting powder	cob of corn
boxed wine (3)	MIX	fermenting powder	bunch of square grapes


# Standard, tier 1 and tier 2 beverages.  Nothing special about
# these mixtures except everyone can make them.

bloody beer	MIX	tomato	ice-cold Sir Schlitz
bloody mary	MIX	tomato	bottle of vodka
eggnog	MIX	ghuol egg	spiced rum
fine wine	MIX	fermenting powder	grapes
papaya sling	MIX	papaya	bottle of gin
shot of flower schnapps	MIX	fermenting powder	pretty flower
shot of grapefruit schnapps	MIX	fermenting powder	grapefruit
shot of orange schnapps	MIX	fermenting powder	orange
shot of tomato schnapps	MIX	fermenting powder	tomato
bottle of sake (3)	MIX	fermenting powder	white rice
green beer	MIX	ten-leaf clover	ice-cold Sir Schlitz
pebblebr&auml;u	MIX	floaty pebbles	ice-cold Sir Schlitz


# Tier 3 and tier 4 beverages which can be made by anyone.  These are
# believed to be the best creatable drinks without buying a DB's skills or
# using a tiny plastic sword.

banana daiquiri	MIX	bottle of rum	banana
extra-spicy bloody mary	MIX	bloody mary	spices
especially salty dog	MIX	salty dog	brine
margarita	MIX	bottle of tequila	lemon
martini	MIX	bottle of gin	olive
monkey wrench	MIX	bottle of rum	grapefruit
salty dog	MIX	bottle of gin	grapefruit
redrum	MIX	bottle of rum	cranberries
rum and cola	MIX	bottle of rum	Dyspepsi-Cola
screwdriver	MIX	bottle of vodka	orange
spiced rum	MIX	bottle of rum	spices
strawberry daiquiri	MIX	bottle of rum	strawberry
strawberry wine	MIX	boxed wine	strawberry
tequila sunrise	MIX	bottle of tequila	orange
vodka and cranberry	MIX	bottle of vodka	cranberries
vodka martini	MIX	bottle of vodka	olive
whiskey and cola	MIX	bottle of whiskey	Dyspepsi-Cola
whiskey and soda	MIX	bottle of whiskey	soda water
whiskey sour	MIX	bottle of whiskey	lemon
white Canadian	MIX	bottle of vodka	glass of goat's milk
White Hyborian	MIX	bottle of vodka	glass of baboon milk
wine spritzer	MIX	boxed wine	soda water


# Hilarious drinks makable by anyone.

calle de miel with a fly in it	MIX	margarita	magical ice cube with a fly in it
perpendicular hula with a fly in it	MIX	strawberry daiquiri	magical ice cube with a fly in it
rockin' wagon with a fly in it	MIX	vodka martini	magical ice cube with a fly in it
slap and tickle with a fly in it	MIX	salty dog	magical ice cube with a fly in it
Mae West with a fly in it	MIX	rabbit punch	magical ice cube with a fly in it
mandarina colada with a fly in it	MIX	zmobie	magical ice cube with a fly in it
tangarita with a fly in it	MIX	tequila sunset	magical ice cube with a fly in it
prussian cathouse with a fly in it	MIX	parisian cathouse	magical ice cube with a fly in it
blended frozen swill with a fly in it	MIX	Typical Tavern swill	magical ice cube with a fly in it


# Tier 3, 4 and 5 beverages which can only be made by someone with
# Advanced Cocktailcrafting.  These include the popular umbrella,
# coconut and ice drinks.

a little sump'm sump'm	ACOCK	martini	little paper umbrella
horizontal tango	ACOCK	wine spritzer	little paper umbrella
roll in the hay	ACOCK	whiskey and soda	little paper umbrella
ducha de oro	ACOCK	tequila sunrise	little paper umbrella

an evil little sump'm sump'm	ACOCK	martini	evil paper umbrella
evil ducha de oro	ACOCK	tequila sunrise	evil paper umbrella
evil horizontal tango	ACOCK	wine spritzer	evil paper umbrella
evil roll in the hay	ACOCK	whiskey and soda	evil paper umbrella

fuzzbump	ACOCK	whiskey sour	coconut shell
slip 'n' slide	ACOCK	screwdriver	coconut shell
ocean motion	ACOCK	monkey wrench	coconut shell
pink pony	ACOCK	strawberry wine	coconut shell

slap and tickle	ACOCK	salty dog	magical ice cubes
rockin' wagon	ACOCK	vodka martini	magical ice cubes
perpendicular hula	ACOCK	strawberry daiquiri	magical ice cubes
calle de miel	ACOCK	margarita	magical ice cubes

bungle in the jungle	ACOCK	banana daiquiri	little paper umbrella

tropical swill	ACOCK	Typical Tavern swill	coconut shell
fruity girl swill	ACOCK	Typical Tavern swill	little paper umbrella
blended frozen swill	ACOCK	Typical Tavern swill	magical ice cubes

berry-infused sake	SCOCK	bottle of Pete's Sake	sea lychee
citrus-infused sake	SCOCK	bottle of Pete's Sake	sea tangelo
melon-infused sake	SCOCK	bottle of Pete's Sake	sea honeydew

screwdiver	MIX	sea tangelo	slug of vodka
dew yoana lei	MIX	sea honeydew	slug of rum
lychee chuhai	MIX	sea lychee	slug of shochu

salacious screwdiver	SACOCK	screwdiver	seaode
dew yoana salacious lei	SACOCK	dew yoana lei	seaode
salacious lychee chuhai	SACOCK	lychee chuhai	seaode

# Beverages which can be made by Superhuman Cocktailcrafting

caipifruta	SCOCK	bottle of Lieutenant Freeman	kiwi
gibson	SCOCK	bottle of Calcutta Emerald	cocktail onion
gin and tonic	SCOCK	bottle of Calcutta Emerald	tonic water
mimosette	SCOCK	boxed champagne	kumquat
parisian cathouse	SCOCK	boxed champagne	raspberry
rabbit punch	SCOCK	bottle of Domesticated Turkey	raspberry
teqiwila	SCOCK	bottle of Jorge Sinsonte	kiwi
tequila sunset	SCOCK	bottle of Jorge Sinsonte	tangerine
vodka and tonic	SCOCK	bottle of Definit	tonic water
vodka gibson	SCOCK	bottle of Definit	cocktail onion
whiskey bittersweet	SCOCK	bottle of Domesticated Turkey	kumquat
zmobie	SCOCK	bottle of Lieutenant Freeman	tangerine


# Beverages which can be made by Advanced Cocktailcrafting using
# ingredients available via Superhuman Cocktailcrafting

Divine	ACOCK	whiskey bittersweet	little paper umbrella
gimlet	ACOCK	gin and tonic	little paper umbrella
Gordon Bennett	ACOCK	mimosette	little paper umbrella
yellow brick road	ACOCK	vodka and tonic	little paper umbrella

Mon Tiki	ACOCK	caipifruta	coconut shell
Neuromancer	ACOCK	gibson	coconut shell
teqiwila slammer	ACOCK	teqiwila	coconut shell
vodka stratocaster	ACOCK	vodka gibson	coconut shell

Mae West	ACOCK	rabbit punch	magical ice cubes
mandarina colada	ACOCK	zmobie	magical ice cubes
tangarita	ACOCK	tequila sunset	magical ice cubes
prussian cathouse	ACOCK	parisian cathouse	magical ice cubes


# Tiny plastic sword drinks which can be made by anyone.  Also
# includes skewered items and subingredients.

grog	MIX	bottle of rum	lime
tequila with training wheels	MIX	bottle of tequila	lime
skewered lime	MIX	lime	tiny plastic sword
grogtini	MIX	grog	skewered lime
bodyslam	MIX	tequila with training wheels	skewered lime

sangria	MIX	boxed wine	cherry
old-fashioned	MIX	bottle of whiskey	cherry
skewered cherry	MIX	cherry	tiny plastic sword
sangria del diablo	MIX	sangria	skewered cherry
cherry bomb	MIX	old-fashioned	skewered cherry

dry martini	MIX	bottle of gin	jumbo olive
dry vodka martini	MIX	bottle of vodka	jumbo olive
skewered jumbo olive	MIX	jumbo olive	tiny plastic sword
dirty martini	MIX	dry martini	skewered jumbo olive
vesper	MIX	dry vodka martini	skewered jumbo olive


# Item upgrades accessible with Crosby Nash's Still: Moxie class
# characters with the Superhuman Cocktailcrafting skill

bottle of Calcutta Emerald	BSTILL	bottle of gin
bottle of Definit	BSTILL	bottle of vodka
bottle of Domesticated Turkey	BSTILL	bottle of whiskey
bottle of Jorge Sinsonte	BSTILL	bottle of tequila
bottle of Lieutenant Freeman	BSTILL	bottle of rum
bottle of Ooze-O	BSTILL	bottle of sewage schnapps
bottle of Pete's Sake	BSTILL	bottle of sake
boxed champagne	BSTILL	boxed wine

cocktail onion	MSTILL	olive
kiwi	MSTILL	lemon
kumquat	MSTILL	orange
raspberry	MSTILL	strawberry
tangerine	MSTILL	grapefruit
tonic water	MSTILL	soda water

# Super-advanced Meatsmithing base ingredients.  These items are used
# later in the construction of meat-smithing weapons.

asbestos meat stack	WSMITH	asbestos ore	dense meat stack
chrome meat stack	WSMITH	chrome ore	dense meat stack
linoleum meat stack	WSMITH	linoleum ore	dense meat stack


# Super-advanced Meatsmithing weapons.

asbestos crossbow	WSMITH	sinewy crossbow string	asbestos meat stack
asbestos staff	WSMITH	bigger stick	asbestos meat stack
asbestos sword	WSMITH	sturdy sword hilt	asbestos meat stack
hot cross bow	WSMITH	asbestos crossbow	hot nuggets
smoldering staff	WSMITH	asbestos staff	patchouli incense stick
Spirit Precipice	WSMITH	asbestos sword	glowing red eye

chrome crossbow	WSMITH	sinewy crossbow string	chrome meat stack
chrome staff	WSMITH	bigger stick	chrome meat stack
chrome sword	WSMITH	sturdy sword hilt	chrome meat stack
carob cannon	WSMITH	chrome crossbow	carob chunks
meatspout staff	WSMITH	chrome staff	meat vortex
sword behind inappropriate prepositions	WSMITH	chrome sword	facsimile dictionary

linoleum crossbow	WSMITH	sinewy crossbow string	linoleum meat stack
linoleum staff	WSMITH	bigger stick	linoleum meat stack
linoleum sword	WSMITH	sturdy sword hilt	linoleum meat stack
projectile icemaker	WSMITH	linoleum crossbow	cold nuggets
hairy staff	WSMITH	linoleum staff	goat beard
shuddersword	WSMITH	linoleum sword	spooky nuggets

bar whip	WSMITH	whip kit	bar skin
bat whip	WSMITH	whip kit	leathery bat skin
clown whip	WSMITH	whip kit	clown skin
demon whip	WSMITH	whip kit	demon skin
gnauga hide whip	WSMITH	whip kit	gnauga hide
hippo whip	WSMITH	whip kit	hippopotamus skin
penguin whip	WSMITH	whip kit	penguin skin
rattail whip	WSMITH	whip kit	leathery rat skin
tail o' nine cats	WSMITH	whip kit	leathery cat skin
white whip	WSMITH	whip kit	white snake skin
yak whip	WSMITH	whip kit	yak skin

club of the five seasons	WSMITH	bigger stick	prismatic wad
rainbow crossbow	WSMITH	dense meat crossbow	prismatic wad
six-rainbow shield	ASMITH	wonderwall shield	prismatic wad

bad-ass club	SUSE	ingot of seal-iron

creepy-ass club	WSMITH	bad-ass club	seal lube
evil-ass club	WSMITH	bad-ass club	scrap of shadow
frigid-ass club	WSMITH	bad-ass club	frost-rimed seal hide
hot-ass club	WSMITH	bad-ass club	sizzling seal fat
nasty-ass club	WSMITH	bad-ass club	fustulent seal grulch

soup-chucks	WSMITH	soup turtle	soup turtle

rainbow bomb	COMBINE	stick of dynamite	prismatic wad

# Meat-smithing weapons.  These items are grouped based on the
# type of base material used in their creation.

basic meat crossbow	SMITH	crossbow string	meat stack
basic meat staff	SMITH	big stick	meat stack
basic meat sword	SMITH	sword hilt	meat stack

dense meat crossbow	SMITH	sinewy crossbow string	dense meat stack
dense meat staff	SMITH	bigger stick	dense meat stack
dense meat sword	SMITH	sturdy sword hilt	dense meat stack

savory crossbow	SMITH	dense meat crossbow	scrumptious reagent
savory staff	SMITH	dense meat staff	scrumptious reagent
savory sword	SMITH	dense meat sword	scrumptious reagent
goulauncher	SMITH	savory crossbow	ghuol guolash
soylent staff	SMITH	savory staff	wad of tofu
Super Magic Power Sword X	SMITH	savory sword	Tasty Fun Good rice candy

basic meat foon	SMITH	foon	meat stack
foon of fulmination	SMITH	basic meat foon	hot powder
foon of frigidity	SMITH	basic meat foon	cold powder
foon of foulness	SMITH	basic meat foon	stench powder
foon of fearfulness	SMITH	basic meat foon	spooky powder
foon of fleshiness	SMITH	basic meat foon	sleaze powder

basic meat spork	SMITH	meat stack	spork

bubblewrap crossbow	SMITH	basic meat crossbow	bubblewrap ore
bubble bauble bow	SMITH	bubblewrap crossbow	dope gangsta bling-bling
bubblewrap staff	SMITH	basic meat staff	bubblewrap ore
wiffle-flail	SMITH	bubblewrap staff	baseball
bubblewrap sword	SMITH	basic meat sword	bubblewrap ore
sword of static	SMITH	bubblewrap sword	long skinny balloon

cardboard crossbow	SMITH	basic meat crossbow	cardboard ore
grease gun	SMITH	cardboard crossbow	White Citadel burger
cardboard staff	SMITH	basic meat staff	cardboard ore
flypaper staff	SMITH	cardboard staff	pine tar
cardboard sword	SMITH	basic meat sword	cardboard ore
flaming cardboard sword	SMITH	cardboard sword	hot powder

styrofoam crossbow	SMITH	basic meat crossbow	styrofoam ore
can cannon	SMITH	styrofoam crossbow	razor-sharp can lid
styrofoam staff	SMITH	basic meat staff	styrofoam ore
squeaky staff	SMITH	styrofoam staff	sonar-in-a-biscuit
styrofoam sword	SMITH	basic meat sword	styrofoam ore
Frost&trade; brand sword	SMITH	styrofoam sword	cold powder

dripping meat crossbow	SMITH	basic meat crossbow	ketchup
repeating crossbow	SMITH	dripping meat crossbow	meat engine
dripping meat staff	SMITH	basic meat staff	ketchup
glistening staff	SMITH	dripping meat staff	sleaze powder
dripping meat sword	SMITH	basic meat sword	ketchup
muculent machete	SMITH	dripping meat sword	forest tears

eXtreme meat crossbow	SMITH	basic meat crossbow	stone of eXtreme power
eXtreme meat staff	SMITH	basic meat staff	stone of eXtreme power
eXtreme meat sword	SMITH	basic meat sword	stone of eXtreme power

Kentucky-fried meat crossbow	SMITH	secret blend of herbs and spices	dense meat crossbow
potato pistol	SMITH	Kentucky-fried meat crossbow	t8r tots
Kentucky-fried meat staff	SMITH	secret blend of herbs and spices	dense meat staff
giant cheesestick	SMITH	Kentucky-fried meat staff	goat cheese
Kentucky-fried meat sword	SMITH	secret blend of herbs and spices	dense meat sword
buffalo blade	SMITH	Kentucky-fried meat sword	hot wing

starchy crossbow	SMITH	basic meat crossbow	dry noodles
curdflinger	SMITH	starchy crossbow	bowl of cottage cheese
starchy staff	SMITH	basic meat staff	dry noodles
poutine pole	SMITH	starchy staff	poutine
starchy sword	SMITH	basic meat sword	dry noodles
pestoblade	SMITH	starchy sword	spices

ram-battering staff	SMITH	ram horns	ram stick
icy-hot katana	SMITH	icy katana hilt	hot katana blade


# Meat-smithing armor pieces.  These items are helmets, pants,
# and sometimes accessories which are created in smithing.

meaty helmet turtle	ASMITH	helmet turtle	dense meat stack
asbestos helmet turtle	ASMITH	meaty helmet turtle	asbestos ore
chrome helmet turtle	ASMITH	meaty helmet turtle	chrome ore
linoleum helmet turtle	ASMITH	meaty helmet turtle	linoleum ore

basic meat pants	SMITH	meat stack	pants kit
basic meat helmet	SMITH	meat stack	helmet recipe
enchantlers	SMITH	basic meat helmet	ram horns
meatloaf helmet	SMITH	basic meat helmet	ketchup
raspberry beret	SMITH	basic meat helmet	raspberry

basic meat fez	SMITH	basic meat helmet	tassel
sequined fez	SMITH	basic meat fez	teeny-tiny ninja stars

grass blade	SMITH	fake plastic grass	sword hilt
grass hat	SMITH	fake plastic grass	helmet recipe
grass skirt	SMITH	fake plastic grass	skirt / kilt kit

fez of etymology	SMITH	basic meat fez	facsimile dictionary

meat cowboy hat	SMITH	basic meat helmet	white snake skin
pimpin' meat hat	SMITH	basic meat helmet	dope gangsta bling-bling


# Weapon made via armorcrafting

# There are two equivalent recipes
gatorskin umbrella	ASMITH	titanium assault umbrella	gator skin
# gatorskin umbrella	ASMITH	goatskin umbrella	gator skin


# Accessories made of hides of various sorts.

black belt	ASMITH	black snake skin	enormous belt buckle
clownskin belt	SMITH	clown skin	big red clown nose
ratskin belt	ASMITH	leathery rat skin	enormous belt buckle
# white belt	SMITH	white snake skin	enormous belt buckle


# Hats made of hides of various sorts.

barskin hat	SMITH	basic meat helmet	bar skin
bat hat	ASMITH	basic meat helmet	leathery bat skin
black cowboy hat	ASMITH	basic meat helmet	black snake skin
catskin cap	ASMITH	basic meat helmet	leathery cat skin
clown wig	SMITH	basic meat helmet	clown skin
demon-horned hat	SMITH	basic meat helmet	demon skin
eelskin hat	ASMITH	basic meat helmet	eel skin
nasty rat mask	ASMITH	basic meat helmet	leathery rat skin
sponge helmet	ASMITH	basic meat helmet	slab of sponge
yak toupee	ASMITH	basic meat helmet	yak skin


# Pants made of hides of various sorts.

barskin loincloth	SMITH	bar skin	pants kit
demonskin trousers	SMITH	demon skin	pants kit
eelskin pants	ASMITH	eel skin	pants kit
furry pants	ASMITH	furry fur	pants kit
hippopotamus pants	ASMITH	hippopotamus skin	pants kit
penguin shorts	ASMITH	penguin skin	pants kit
square sponge pants	ASMITH	slab of sponge	basic meat pants
sticky meat pants	SMITH	really really sticky spider web	basic meat pants
tighty whiteys	SMITH	white snake skin	pants kit
yakskin pants	ASMITH	yak skin	pants kit
gnauga hide chaps	ASMITH	gnauga hide	pants kit


# Skirts made of hides of various sorts.

basic meat skirt	SMITH	meat stack	skirt / kilt kit
sticky meat skirt	SMITH	really really sticky spider web	basic meat skirt

furry skirt	ASMITH	furry fur	skirt / kilt kit
gnauga hide skirt	ASMITH	gnauga hide	skirt / kilt kit
hippopotamus skirt	ASMITH	hippopotamus skin	skirt / kilt kit
penguinskin mini-skirt	ASMITH	penguin skin	skirt / kilt kit
yakskin skirt	ASMITH	yak skin	skirt / kilt kit


# Kilts made of hides of various sorts.

basic meat kilt	SMITH	meat stack	skirt / kilt kit
sticky meat kilt	SMITH	really really sticky spider web	basic meat kilt

furry kilt	ASMITH	furry fur	skirt / kilt kit
gnauga hide kilt	ASMITH	gnauga hide	skirt / kilt kit
hippopotamus kilt	ASMITH	hippopotamus skin	skirt / kilt kit
penguinskin mini-kilt	ASMITH	penguin skin	skirt / kilt kit
yakskin kilt	ASMITH	yak skin	skirt / kilt kit


# Bucklers made of hides of various sorts.

barskin buckler	ASMITH	buckler buckle	bar skin
catskin buckler	ASMITH	buckler buckle	leathery cat skin
clownskin buckler	ASMITH	buckler buckle	clown skin
demon buckler	ASMITH	buckler buckle	demon skin
gnauga hide buckler	ASMITH	buckler buckle	gnauga hide
hippo skin buckler	ASMITH	buckler buckle	hippopotamus skin
penguin skin buckler	ASMITH	buckler buckle	penguin skin
yakskin buckler	ASMITH	buckler buckle	yak skin

# Advanced Shields

meat shield	ASMITH	buckler buckle	dense meat stack
eelskin shield	ASMITH	meat shield	eel skin
painted shield	ASMITH	meat shield	painted turtle
spiky turtle shield	ASMITH	meat shield	hedgeturtle
spongy shield	ASMITH	meat shield	slab of sponge
tortoboggan shield	ASMITH	tortoboggan	tortoboggan

# Shirts made of hides of various sorts.

barskin cloak	ASMITH	shirt kit	bar skin
bat-ass leather jacket	ASMITH	shirt kit	leathery bat skin
clownskin harness	ASMITH	shirt kit	clown skin
demonskin jacket	ASMITH	shirt kit	demon skin
gnauga hide vest	ASMITH	shirt kit	gnauga hide
hipposkin poncho	ASMITH	shirt kit	hippopotamus skin
tuxedo shirt	ASMITH	shirt kit	penguin skin
white snakeskin duster	ASMITH	shirt kit	white snake skin
yak anorak	ASMITH	shirt kit	yak skin


# Things made of special turtles

ancient turtle shell helmet	ASMITH	basic meat helmet	ancient turtle shell
bubblewrap bottlecap turtleban	ASMITH	bubblewrap ore	bottlecap turtle
cardboard box turtle	ASMITH	cardboard ore	box turtle
furry green earmuffs	ASMITH	furry green turtle	furry green turtle
knobby kneepads	ASMITH	knobby helmet turtle	knobby helmet turtle
reinforced furry underpants	ASMITH	bar skin	skeletortoise
samurai turtle helmet	ASMITH	basic meat helmet	samurai turtle
sebaceous shield	ASMITH	bum cheek	sewer turtle
spiky turtle helmet	ASMITH	basic meat helmet	hedgeturtle
spiky turtle shoulderpads	ASMITH	hedgeturtle	hedgeturtle

eXtreme nose ring	COMBINE	stone of eXtreme power	piercing post
spooky glove	COOK	spooky fairy gravy	small leather glove

# Things made of ores from the Anemone Mine

decaying wooden oar	COMBINE	decaying wooden pole	decaying wooden paddle
giant fishhook	COMBINE	tarnished metal ring	tarnished metal rod
rusty old lantern	COMBINE	brittle plastic handle	foggy glass globe

non-stick pugil stick	WSMITH	decaying wooden pole	teflon ore
teflon spatula	WSMITH	tarnished metal rod	teflon ore
teflon shield	ASMITH	rusty valve wheel	teflon ore
teflon swim fins	ASMITH	waterlogged bootstraps	teflon ore

velcro broadsword	WSMITH	brittle plastic handle	velcro ore
velcro paddle ball	WSMITH	decaying wooden paddle	velcro ore
velcro shield	ASMITH	rusty valve wheel	velcro ore
velcro boots	ASMITH	waterlogged bootstraps	velcro ore

7-inch discus	WSMITH	tarnished metal ring	vinyl ore
PVC staff	WSMITH	foggy glass globe	vinyl ore
vinyl shield	ASMITH	rusty valve wheel	vinyl ore
vinyl boots	ASMITH	waterlogged bootstraps	vinyl ore


# Time Trappings, smithable by anyone.

time helmet	SMITH	petrified time	helmet recipe
time trousers	SMITH	petrified time	pants kit
time sword	SMITH	petrified time	sword hilt


# Elemental powders can be compressed into nuggets and wads with the Malus

twinkly nuggets	MALUS	twinkly powder (5)
hot nuggets	MALUS	hot powder (5)
cold nuggets	MALUS	cold powder (5)
spooky nuggets	MALUS	spooky powder (5)
stench nuggets	MALUS	stench powder (5)
sleaze nuggets	MALUS	sleaze powder (5)

twinkly wad	MALUS	twinkly nuggets (5)
hot wad	MALUS	hot nuggets (5)
cold wad	MALUS	cold nuggets (5)
sewer wad	MALUS	sewer nuggets (5)
spooky wad	MALUS	spooky nuggets (5)
stench wad	MALUS	stench nuggets (5)
sleaze wad	MALUS	sleaze nuggets (5)

floaty pebbles	MALUS	floaty sand (5)
floaty gravel	MALUS	floaty pebbles (5)
floaty rock	MALUS	floaty gravel (5)

# KoLmafia currently doesn't support items with more than one creation method

# hot wad	SSAUCE	twinkly wad	sleaze wad
# cold wad	SSAUCE	twinkly wad	hot wad
# spooky wad	SSAUCE	twinkly wad	cold wad
# stench wad	SSAUCE	twinkly wad	spooky wad
# sleaze wad	SSAUCE	twinkly wad	stench wad


# Potions you can make by cooking

vial of baconstone juice	COOK	vial of Gnomochloric acid	baconstone
vial of hamethyst juice	COOK	vial of Gnomochloric acid	hamethyst
vial of porquoise juice	COOK	vial of Gnomochloric acid	porquoise

flask of baconstone juice	COOK	flask of Gnomochloric acid	baconstone
flask of hamethyst juice	COOK	flask of Gnomochloric acid	hamethyst
flask of porquoise juice	COOK	flask of Gnomochloric acid	porquoise

jug of baconstone juice	COOK	jug of Gnomochloric acid	baconstone
jug of hamethyst juice	COOK	jug of Gnomochloric acid	hamethyst
jug of porquoise juice	COOK	jug of Gnomochloric acid	porquoise


# Reagent potions.  Not to be confused with reagent broth mixtures
# which can be combined with pasta by pastamancers.

banana smoothie	SAUCE	scrumptious reagent	banana
cordial of concentration	SAUCE	scrumptious reagent	soda water
cranberry cordial	SAUCE	scrumptious reagent	cranberries
eyedrops of the ermine	SAUCE	scrumptious reagent	strawberry
libation of liveliness	SAUCE	scrumptious reagent	grapes
milk of magnesium	SAUCE	scrumptious reagent	glass of goat's milk
oil of expertise	SAUCE	scrumptious reagent	cherry
oil of oiliness	SAUCE	scrumptious reagent	decaying goldfish liver
oil of slipperiness	SAUCE	scrumptious reagent	jumbo olive
oil of stability	SAUCE	scrumptious reagent	lime
ointment of the occult	SAUCE	scrumptious reagent	grapefruit
perfume of prejudice	SAUCE	scrumptious reagent	jaba&ntilde;ero pepper
philter of phorce	SAUCE	scrumptious reagent	lemon
potion of potency	SAUCE	scrumptious reagent	orange
serum of sarcasm	SAUCE	scrumptious reagent	olive
tomato juice of powerful power	SAUCE	scrumptious reagent	tomato

evil eyedrops of the ermine	SAUCE	nauseating reagent	strawberry
evil libation of liveliness	SAUCE	nauseating reagent	grapes
evil ointment of the occult	SAUCE	nauseating reagent	grapefruit
evil philter of phorce	SAUCE	nauseating reagent	lemon
evil potion of potency	SAUCE	nauseating reagent	orange
evil serum of sarcasm	SAUCE	nauseating reagent	olive
evil tomato juice of powerful power	SAUCE	nauseating reagent	tomato

salamander slurry	SAUCE	scrumptious reagent	salamander spleen
eyedrops of newt	SAUCE	scrumptious reagent	eye of newt
Frogade	SAUCE	scrumptious reagent	squashed frog

papotion of papower	SAUCE	scrumptious reagent	papaya
concoction of clumsiness	SAUCE	scrumptious reagent	lion oil

# Advanced Sauces

scrumdiddlyumptious solution	SUSE	delectable catalyst	scrumptious reagent

# Reagent potions.

Connery's Elixir of Audacity	SSAUCE	scrumdiddlyumptious solution	cocktail onion
Hawking's Elixir of Brilliance	SSAUCE	scrumdiddlyumptious solution	tangerine
Ferrigno's Elixir of Power	SSAUCE	scrumdiddlyumptious solution	kiwi
blackberry polite	SSAUCE	scrumdiddlyumptious solution	blackberry
cologne of contempt	SSAUCE	scrumdiddlyumptious solution	dill
concentrated cordial of concentration	SSAUCE	scrumdiddlyumptious solution	tonic water
potent potion of potency	SSAUCE	scrumdiddlyumptious solution	kumquat
eyedrops of the ocelot	SSAUCE	scrumdiddlyumptious solution	raspberry
peach lozenge	SSAUCE	scrumdiddlyumptious solution	peach
pear lozenge	SSAUCE	scrumdiddlyumptious solution	pear
plum lozenge	SSAUCE	scrumdiddlyumptious solution	plum
potion of temporary gr8tness	SSAUCE	scrumdiddlyumptious solution	gr8ps

phial of hotness	SAUCE	scrumptious reagent	hot powder
phial of coldness	SAUCE	scrumptious reagent	cold powder
phial of spookiness	SAUCE	scrumptious reagent	spooky powder
phial of stench	SAUCE	scrumptious reagent	stench powder
phial of sleaziness	SAUCE	scrumptious reagent	sleaze powder

# Deep Sauces

pressurized potion of perception	DSAUCE	globe of Deep Sauce	sea blueberry
pressurized potion of perspicacity	DSAUCE	globe of Deep Sauce	sea honeydew
pressurized potion of proficiency	DSAUCE	globe of Deep Sauce	sea persimmon
pressurized potion of puissance	DSAUCE	globe of Deep Sauce	sea tangelo
pressurized potion of pulchritude	DSAUCE	globe of Deep Sauce	sea lychee
pressurized potion of pneumaticity	DSAUCE	globe of Deep Sauce	[0]

# Simple pastamancer recipes.  Available to pastamancers only, and
# creates pasta if you don't have finer ingredients.

boring spaghetti	PASTA	dry noodles	tomato
delicious noodles	PASTA	dry noodles	herbs
delicious spicy noodles	PASTA	dry noodles	secret blend of herbs and spices
painful penne pasta	PASTA	dry noodles	jaba&ntilde;ero pepper
pr0n m4nic0tti	PASTA	dry noodles	pr0n legs
ravioli della hippy	PASTA	dry noodles	wad of tofu
spicy noodles	PASTA	dry noodles	spices

evil boring spaghetti	PASTA	evil noodles	tomato
evil delicious noodles	PASTA	evil noodles	herbs
evil delicious spicy noodles	PASTA	evil noodles	secret blend of herbs and spices
evil painful penne pasta	PASTA	evil noodles	jaba&ntilde;ero pepper
3vi1 pr0n m4nic0tti	PASTA	evil noodles	pr0n legs
evil ravioli della hippy	PASTA	evil noodles	wad of tofu
evil spicy noodles	PASTA	evil noodles	spices



# Items involved in the famous pastamancer-sauceror lunch creation
# duo - end items and non-end items.

fancy schmancy cheese sauce	SAUCE	scrumptious reagent	goat cheese
fettucini Inconnu	PASTA	fancy schmancy cheese sauce	dry noodles

Hell broth	SAUCE	scrumptious reagent	hellion cube
Hell ramen	PASTA	Hell broth	dry noodles

Himalayan Hidalgo sauce	SAUCE	scrumptious reagent	Knob mushroom
gnocchetti di Nietzsche	PASTA	Himalayan Hidalgo sauce	dry noodles

sauce of the ages	SAUCE	scrumptious reagent	Knob sausage
spaghetti with Skullheads	PASTA	sauce of the ages	dry noodles


# Stir-fry items.  These are the main ingredients or are sub-ingredients
# of chow mein items.

secret blend of herbs and spices	COOK	herbs	spices

asparagus stir-fry	COOK	stalk of asparagus	secret blend of herbs and spices
Knob stir-fry	COOK	Knob mushroom	secret blend of herbs and spices
Knoll stir-fry	COOK	Knoll mushroom	secret blend of herbs and spices
olive stir-fry	COOK	olive	secret blend of herbs and spices
spooky stir-fry	COOK	spooky mushroom	secret blend of herbs and spices

bat wing stir-fry	COOK	bat wing	Knob stir-fry
Knob sausage stir-fry	COOK	Knob sausage	Knoll stir-fry
pr0n stir-fry	COOK	pr0n legs	olive stir-fry
rat appendix stir-fry	COOK	rat appendix	spooky stir-fry
tofu stir-fry	COOK	wad of tofu	asparagus stir-fry


# Middle-end foods made by cooking stir-fries with dry noodles

asparagus lo mein	PASTA	asparagus stir-fry	dry noodles
Knob lo mein	PASTA	Knob stir-fry	dry noodles
Knoll lo mein	PASTA	Knoll stir-fry	dry noodles
olive lo mein	PASTA	olive stir-fry	dry noodles
spooky lo mein	PASTA	spooky stir-fry	dry noodles


# High-end foods made by upgrading stir-fries at the Wok of Ages

bat wing chow mein	WOK	bat wing stir-fry	dry noodles	MSG
Knob sausage chow mein	WOK	Knob sausage stir-fry	dry noodles	MSG
pr0n chow mein	WOK	pr0n stir-fry	dry noodles	MSG
rat appendix chow mein	WOK	rat appendix stir-fry	dry noodles	MSG
tofu chow mein	WOK	tofu stir-fry	dry noodles	MSG

unfortunate dumplings	WOK	C.H.U.M. chum	dry noodles	MSG
wok lobster	WOK	live lobster	dry noodles	MSG

cold and sour sauce	SSAUCE	scrumdiddlyumptious solution	cold nuggets
hot and sour sauce	SSAUCE	scrumdiddlyumptious solution	hot nuggets
sleazy and sour sauce	SSAUCE	scrumdiddlyumptious solution	sleaze nuggets
spooky and sour sauce	SSAUCE	scrumdiddlyumptious solution	spooky nuggets
stench and sour sauce	SSAUCE	scrumdiddlyumptious solution	stench nuggets


# Top-end foods made by upgrading element-and-sour sauces at the Wok of Ages

cold hi mein	WOK	cold and sour sauce	dry noodles	MSG
hot hi mein	WOK	hot and sour sauce	dry noodles	MSG
sleazy hi mein	WOK	sleazy and sour sauce	dry noodles	MSG
spooky hi mein	WOK	spooky and sour sauce	dry noodles	MSG
stinky hi mein	WOK	stench and sour sauce	dry noodles	MSG


# Top-end foods made by upgrading other things at the Wok of Ages

fishy fish lasagna	WOK	fishy fish casserole	dry noodles	MSG
gnat lasagna	WOK	gnatloaf casserole	dry noodles	MSG
long pork lasagna	WOK	long pork casserole	dry noodles	MSG
sausage wonton	WOK	beer basted brat	dry noodles	MSG
tofu wonton	WOK	super salad	dry noodles	MSG


# Tempura foods

tempura avocado	TEMPURA	bubbling tempura batter	sea avocado
tempura broccoli	TEMPURA	bubbling tempura batter	sea broccoli
tempura carrot	TEMPURA	bubbling tempura batter	sea carrot
tempura cauliflower	TEMPURA	bubbling tempura batter	sea cauliflower
tempura cucumber	TEMPURA	bubbling tempura batter	sea cucumber
tempura radish	TEMPURA	bubbling tempura batter	sea radish
tempura air	TEMPURA	bubbling tempura batter	[0]

# Star Chart items

star boomerang	STAR	star chart	star (4)	line (5)
star buckler	STAR	star chart	star (4)	line (6)
star crossbow	STAR	star chart	star (5)	line (6)
star hat	STAR	star chart	star (5)	line (3)
star pants	STAR	star chart	star (7)	line (7)
star spatula	STAR	star chart	star (5)	line (5)
star staff	STAR	star chart	star (6)	line (5)
star starfish	STAR	star chart	star (6)	line (4)
star stiletto	STAR	star chart	star (5)	line (4)
star sword	STAR	star chart	star (7)	line (4)
star throwing star	STAR	star chart	star (4)	line (2)
Richard's star key	STAR	star chart	star (8)	line (7)
star shirt	STAR	star chart	star (15)	line (15)


# Pixel items.  These are items which are created at the Crackpot
# mystic after collecting enough pixels.

white pixel	PIXEL	red pixel	green pixel	blue pixel
red pixel potion	PIXEL	black pixel (3)	red pixel (2)
blue pixel potion	PIXEL	black pixel (3)	blue pixel (2)
green pixel potion	PIXEL	black pixel (4)	green pixel (3)
monster bait	PIXEL	red pixel (20)	white pixel (15)
purple pixel pie	PIXEL	white pixel (5)	red pixel (2)	blue pixel (2)
pixel hat	PIXEL	white pixel (10)	green pixel (15)
pixel pants	PIXEL	black pixel (10)	red pixel (20)
pixel sword	PIXEL	white pixel (20)	black pixel (10)	blue pixel (10)
pixel shield	PIXEL	red pixel (20)	black pixel (10)	white pixel (10)
digital key	PIXEL	white pixel (30)
pixel boomerang	PIXEL	black pixel (10)	white pixel (10)	blue pixel (20)


# Jewelry making recipes.  These are recipes which are only available
# once you acquire jewelry-making pliers.

hamethyst earring	JEWEL	hamethyst	piercing post
hamethyst necklace	JEWEL	hamethyst	necklace chain
hamethyst ring	JEWEL	hamethyst	ring setting
baconstone earring	JEWEL	baconstone	piercing post
baconstone pendant	JEWEL	baconstone	necklace chain
baconstone ring	JEWEL	baconstone	ring setting
porquoise eyebrow ring	JEWEL	porquoise	piercing post
porquoise necklace	JEWEL	porquoise	necklace chain
porquoise ring	JEWEL	porquoise	ring setting

rainbow pearl earring	JEWEL	rainbow pearl	piercing post
rainbow pearl necklace	JEWEL	rainbow pearl	necklace chain
rainbow pearl ring	JEWEL	rainbow pearl	ring setting

vampire pearl earring	JEWEL	vampire pearl	piercing post
vampire pearl necklace	JEWEL	vampire pearl	necklace chain
vampire pearl ring	JEWEL	vampire pearl	ring setting

torquoise ring	JEWEL	torquoise	ring setting

# Expensive Jewelry making recipes.  These require jewelry-making pliers
# and the Really Expensive Jewelrycrafting skill

filigreed hamethyst ring	EJEWEL	hamethyst	extra-fancy ring setting
filigreed hamethyst earring	EJEWEL	hamethyst	precious piercing post
filigreed hamethyst necklace	EJEWEL	hamethyst	heavy necklace chain

solid baconstone ring	EJEWEL	baconstone	extra-fancy ring setting
solid baconstone earring	EJEWEL	baconstone	precious piercing post
solid baconstone necklace	EJEWEL	baconstone	heavy necklace chain

pulled porquoise ring	EJEWEL	porquoise	extra-fancy ring setting
pulled porquoise earring	EJEWEL	porquoise	precious piercing post
pulled porquoise pendant	EJEWEL	porquoise	heavy necklace chain

Earring of Fire	EJEWEL	steamy ruby	precious piercing post
Pendant of Fire	EJEWEL	steamy ruby	heavy necklace chain
Ring of Fire	EJEWEL	steamy ruby	extra-fancy ring setting

Ice-Cold Beerring	EJEWEL	glacial sapphire	precious piercing post
Ice-Cold Aluminum Necklace	EJEWEL	glacial sapphire	heavy necklace chain
Ice-Cold Beer Ring	EJEWEL	glacial sapphire	extra-fancy ring setting

Unspeakable Earring	EJEWEL	unearthly onyx	precious piercing post
Choker of the Ultragoth	EJEWEL	unearthly onyx	heavy necklace chain
The Ring	EJEWEL	unearthly onyx	extra-fancy ring setting

Nose Ring of Putrescence	EJEWEL	effluvious emerald	precious piercing post
Putrid Pendant	EJEWEL	effluvious emerald	heavy necklace chain
Ring of the Sewer Snake	EJEWEL	effluvious emerald	extra-fancy ring setting

Mudflap-Girl Earring	EJEWEL	tawdry amethyst	precious piercing post
Mudflap-Girl Necklace	EJEWEL	tawdry amethyst	heavy necklace chain
Mudflap-Girl Ring	EJEWEL	tawdry amethyst	extra-fancy ring setting

bezoar ring	EJEWEL	flytrap bezoar	extra-fancy ring setting
groovy prism necklace	EJEWEL	prismatic wad	heavy necklace chain
shark tooth necklace	EJEWEL	shark tooth	heavy necklace chain

# Chef staves made by Rodoric

Staff of Blood and Pudding	STAFF	dripping meat staff	mugcake	bloody mary	twinkly nuggets	bottle of used blood
Staff of the Black Kettle	STAFF	Staff of the Teapot Tempest	olive lo mein	around the world	jug-o-magicalness	magical mystery juice (6)	asbestos ore
Staff of the Deepest Freeze	STAFF	Frosty's arm	bowl of fishysoisse	mandarina colada (3)	epic wad	glacial sapphire (3)	frigid mote
Staff of the Grand Flamb&eacute;	STAFF	smoldering staff	hot hi mein (3)	flaming mushroom wine	hot wad (10)	flaming feather
Staff of the Grease Trap	STAFF	giant cheesestick	sleazy hi mein (3)	flat mushroom wine	sleaze wad (10)	flirtatious feather
Staff of the Greasefire	STAFF	Kentucky-fried meat staff	spicy noodles	bottle of tequila	hot nuggets	sleaze nuggets
Staff of the Kitchen Floor	STAFF	linoleum staff	stinky hi mein (3)	stinky mushroom wine	stench wad (10)	fetid feather
Staff of the Midnight Snack	STAFF	spooky staff	fricasseed brains	bottle of popskull	spooky powder (3)	spray paint (3)
Staff of the Short Order Cook	STAFF	basic meat staff	bowl of cottage cheese	ice-cold Sir Schlitz (3)	twinkly powder (3)	magicalness-in-a-can (5)
Staff of the Teapot Tempest	STAFF	big stirring stick	menudo	sangria	hippy herbal tea	concentrated magicalness pill	magical mystery juice (3)
Staff of the Walk-In Freezer	STAFF	ram stick	cold hi mein (3)	icy mushroom wine	cold wad (10)	frozen feather
Staff of the Well-Tempered Cauldron	STAFF	Staff of the Black Kettle	bat wing chow mein	Supernova Champagne	bit-o-cactus	squashed frog	eye of newt	salamander spleen


# Recipes that involve multi-using a quantity of an item

balloon helmet	MUSE	long skinny balloon (2)
balloon monkey	MUSE	long skinny balloon (7)
balloon shield	MUSE	long skinny balloon (4)
balloon sword	MUSE	long skinny balloon (3)

palm-frond fan	MUSE	palm frond (2)
palm-frond net	MUSE	palm frond (3)
palm-frond whip	MUSE	palm frond (4)
palm-frond capris	MUSE	palm frond (5)
extra-large palm-frond toupee	MUSE	palm frond (6)
palm-frond cloak	MUSE	palm frond (7)

really thick bandage	MUSE	mummy wrapping (2)
mummy mask	MUSE	mummy wrapping (4)
gauze shorts	MUSE	mummy wrapping (6)
gauze hammock	MUSE	mummy wrapping (10)

duct tape wallet	MUSE	duct tape (4)
duct tape buckler	MUSE	duct tape (10)
duct tape dockers	MUSE	duct tape (12)
duct tape fedora	MUSE	duct tape (14)
duct tape sword	MUSE	duct tape (17)
duct tape shirt	MUSE	duct tape (23)

clingfilm tangle	MUSE	bit of clingfilm (3)
clingfilm slippers	MUSE	bit of clingfilm (7)
clingfilm cap	MUSE	bit of clingfilm (9)
clingfilm trousers	MUSE	bit of clingfilm (11)

brick of sand	MUSE	handful of sand (5)
sandcastle	MUSE	brick of sand (20)

house of twigs and spit	MUSE	interesting-looking twig (100)

deck of lewd playing cards	MUSE	lewd playing card (52)

propeller beanie	MUSE	Bash-&#332;s boxtop (20)

turtlemail coif	MUSE	turtlemail bits (3)
turtlemail breeches	MUSE	turtlemail bits (5)
turtlemail hauberk	MUSE	turtlemail bits (8)

wumpus-hair bolo	MUSE	wumpus hair (2)
wumpus-hair net	MUSE	wumpus hair (5)
wumpus-hair whip	MUSE	wumpus hair (11)
wumpus-hair wig	MUSE	wumpus hair (16)
wumpus-hair loincloth	MUSE	wumpus hair (23)
wumpus-hair sweater	MUSE	wumpus hair (30)

# Recipes that involve single-using one of the ingredients

booty chest charrrm bracelet	SUSE	booty chest charrrm	charrrm bracelet
cannonball charrrm bracelet	SUSE	cannonball charrrm	charrrm bracelet
copper ha'penny charrrm bracelet	SUSE	copper ha'penny charrrm	charrrm bracelet
grumpy old man charrrm bracelet	SUSE	grumpy old man charrrm	charrrm bracelet
Jolly Roger charrrm bracelet	SUSE	Jolly Roger charrrm	charrrm bracelet
rum barrel charrrm bracelet	SUSE	rum barrel charrrm	charrrm bracelet
silver tongue charrrm bracelet	SUSE	silver tongue charrrm	charrrm bracelet
tarrrnished charrrm bracelet	SUSE	tarrrnish charrrm	charrrm bracelet

charrrm bracelet	SUSE	Jolly Roger charrrm bracelet

turtle wax shield	SUSE	turtle wax
ancient turtle shell powder	SUSE	ancient turtle shell

brown crock marble	SUSE	green peawee marble (2)
red China marble	SUSE	brown crock marble (2)
lemonade marble	SUSE	red China marble (2)
bumblebee marble	SUSE	lemonade marble (2)
jet bennie marble	SUSE	bumblebee marble (2)
beige clambroth marble	SUSE	jet bennie marble (2)
steely marble	SUSE	beige clambroth marble (2)
beach ball marble	SUSE	steely marble (2)
black catseye marble	SUSE	beach ball marble (2)
big bumboozer marble	SUSE	black catseye marble (2)


# Familiars.  These are familiars which are only available after
# ascension (not including the ones which are available through
# post-ascension methods, like supertinkering).

maple leaf	COMBINE	leaf	maple syrup
unwound clockwork grapefruit	COOK	clockwork endoskeleton	grapefruit
deactivated MicroMechaMech	TINKER	clockwork spine	clockwork claws	clockwork key
dusty animal skull	COMBINE	dusty animal cranium	dusty animal jawbone
scary death orb	COMBINE	clockwork sphere	grouchy restless spirit
reassembled blackbird	COMBINE	broken wings	sunken eyes


# These are item-combinations which are only available post-ascension,
# and does not fall into any other categories.

leaf	COMBINE	leaflet	leaflet
wholeberd	COMBINE	halfberd	halfberd


# Foods.  These are foods which are only available post-ascension,
# and include the mushroom recipes.

spicy mushroom quesadilla	COOK	warm mushroom	flat dough
cool mushroom casserole	COOK	cool mushroom	Gnollish casserole dish
cream of pointy mushroom soup	COOK	pointy mushroom	glass of goat's milk


# Drinks.  These are drinks which are only available post-ascension,
# and include the lumberjack and the mushroom wines.

lumbering jack	MIX	bottle of whiskey	Blatantly Canadian
flaming mushroom wine	MIX	mushroom fermenting solution	flaming mushroom
icy mushroom wine	MIX	mushroom fermenting solution	frozen mushroom
stinky mushroom wine	MIX	mushroom fermenting solution	stinky mushroom
pointy mushroom wine	MIX	mushroom fermenting solution	pointy mushroom
flat mushroom wine	MIX	mushroom fermenting solution	warm mushroom
cool mushroom wine	MIX	mushroom fermenting solution	cool mushroom
knob mushroom wine	MIX	mushroom fermenting solution	Knob mushroom
knoll mushroom wine	MIX	mushroom fermenting solution	Knoll mushroom
spooky mushroom wine	MIX	mushroom fermenting solution	spooky mushroom
gloomy mushroom wine	MIX	mushroom fermenting solution	gloomy black mushroom
oily mushroom wine	MIX	mushroom fermenting solution	oily golden mushroom


# Tinker recipes.  These recipes are the recipes which are used in the
# supertinkering process for Moxie signs.

clockwork widget	TINKER	flange	cog	sprocket
clockwork thingamajig	TINKER	flange	cog	spring
clockwork doohickey	TINKER	flange	spring	sprocket
clockwork clockwise dome	TINKER	clockwork widget	flange	spring
clockwork spine	TINKER	clockwork widget	spring	cog
clockwork rings	TINKER	clockwork thingamajig	flange	sprocket
clockwork claws	TINKER	clockwork thingamajig	spring	sprocket
clockwork endoskeleton	TINKER	clockwork claws	clockwork counterclockwise dome	clockwork key
clockwork sheet	TINKER	clockwork doohickey	cog	flange
clockwork counterclockwise dome	TINKER	clockwork doohickey	cog	sprocket
clockwork sphere	TINKER	clockwork counterclockwise dome	clockwork clockwise dome	clockwork key
clockwork handle	TINKER	clockwork doohickey	cog	spring
clockwork rod	TINKER	clockwork thingamajig	cog	sprocket
clockwork shank	TINKER	clockwork widget	spring	sprocket
clockwork hat	TINKER	clockwork clockwise dome	clockwork rings	clockwork key
clockwork trench coat	TINKER	clockwork spine	clockwork sheet	clockwork key
clockwork pants	TINKER	clockwork sheet	clockwork rings	clockwork key
clockwork sword	TINKER	clockwork handle	clockwork shank	clockwork key
clockwork staff	TINKER	clockwork handle	clockwork rod	clockwork key
clockwork crossbow	TINKER	clockwork rod	clockwork shank	clockwork key


# Clockwork servant recipes.  These recipes are used to create clockwork
# counterparts to the standard servants available pre-ascension.

clockwork detective skull	COMBINE	clockwork sphere	gnoll lips

clockwork maid head	COMBINE	clockwork sphere	maiden wig
clockwork maid	COMBINE	clockwork maid head	Meat maid body

clockwork chef head	COMBINE	clockwork sphere	chef's hat
clockwork chef-head-in-the-box	COMBINE	clockwork chef head	nothing-in-the-box
clockwork chef-in-the-box	COMBINE	clockwork chef-head-in-the-box	E-Z Cook Oven&trade;

clockwork bartender head	COMBINE	clockwork sphere	beer goggles
clockwork bartender-head-in-the-box	COMBINE	clockwork bartender head	nothing-in-the-box
clockwork bartender-in-the-box	COMBINE	clockwork bartender-head-in-the-box	cocktailcrafting kit


# Items created via item usage.

dead guy's memento	SUSE	dead guy's piece of double-sided tape	dead guy's watch	picture of a dead guy's girlfriend
rusty diving helmet	SUSE	rusty broken diving helmet	rusty porthole	rusty rivet (8)
scroll of ancient forbidden unspeakable evil	SUSE	disintegrating quill pen	inkwell	tattered scrap of paper
toast with jam	SUSE	jamfish jam	toast

# Crimbo toys.  These are items which are created at Uncle Crimbo
# after collecting enough toy components.

ball	CRIMBO07	stuffing	felt
doll house	CRIMBO07	wooden block (4)	felt (3)
duck-on-a-string	CRIMBO07	length of string	googly eye (2)	wooden block (2)	toy wheel (2)
kite	CRIMBO07	length of string	felt
marionette	CRIMBO07	length of string (2)	googly eye (2)	wooden block (2)
pet rock	CRIMBO07	googly eye	wooden block
rag doll	CRIMBO07	googly eye (2)	stuffing (3)	felt (2)
sock monkey	CRIMBO07	googly eye (2)	stuffing (3)	felt
stuffed doppelshifter	CRIMBO07	googly eye	stuffing
teddy bear	CRIMBO07	googly eye (2)	stuffing (4)	felt (2)
top	CRIMBO07	wooden block	toy wheel
toy soldier	CRIMBO07	googly eye (2)	wooden block (3)
toy train	CRIMBO07	length of string (2)	wooden block (3)	toy wheel (6)
yo-yo	CRIMBO07	length of string	toy wheel

Bulky Buddy Box	CRIMBO07	iGoogly	LED block
borg sock monkey	CRIMBO07	iGoogly (2)	synthetic stuffing (3)	nanofiber cloth
buckyball	CRIMBO07	synthetic stuffing	nanofiber cloth
cyborg doll	CRIMBO07	iGoogly (2)	synthetic stuffing (3)	nanofiber cloth (2)
dollhive	CRIMBO07	nanofiber cloth (3)	LED block (4)
gyroscope	CRIMBO07	LED block	toy hoverpad
marionette collective	CRIMBO07	theoretical string (2)	iGoogly (2)	LED block (2)
monomolecular yo-yo	CRIMBO07	theoretical string	toy hoverpad
mylar scout drone	CRIMBO07	theoretical string	nanofiber cloth
roboduck-on-a-string	CRIMBO07	theoretical string	iGoogly (2)	LED block (2)	toy hoverpad (2)
stuffed gray blob	CRIMBO07	iGoogly	synthetic stuffing
teddy borg	CRIMBO07	iGoogly (2)	nanofiber cloth (2)	synthetic stuffing (4)
toy deathbot	CRIMBO07	iGoogly (2)	LED block (3)
toy maglev monorail	CRIMBO07	theoretical string (2)	LED block (3)	toy hoverpad (6)


# Crimbo tools.  These are items which are created at Ugh Crimbo
# after collecting enough components.

fire	CRIMBO07	stick	stick
prehistoric spear	CRIMBO07	stick	tooth
stick-on-a-string	CRIMBO07	stick	stringy sinew
toothsome rock	CRIMBO07	tooth	rock
wheel	CRIMBO07	stick	rock
yo	CRIMBO07	stringy sinew	rock

leaf tube	CRIMBO06	stringy sinew	big leaf
lit cigar	COMBINE	fire	leaf tube


# Evil Crimbo toys.  These are items which are created by Lady Linnea
# after collecting enough toy components.

evil teddy bear	CRIMBO07	evil googly eye (2)	spooky stuffing (4)	spooky felt (2)
fancy dress ball	CRIMBO07	spooky stuffing	spooky felt
incredibly creepy marionette	CRIMBO07	spooky length of string (2)	evil googly eye (2)	spooky wooden block (2)
killer rag doll	CRIMBO07	evil googly eye (2)	spooky stuffing (3)	spooky felt (2)
mad scientist's sock monkey	CRIMBO07	evil googly eye (2)	spooky stuffing (3)	spooky felt
possessed top	CRIMBO07	spooky wooden block	spooky toy wheel
razor-tipped yo-yo	CRIMBO07	spooky length of string	spooky toy wheel
stuffed alien blob	CRIMBO07	evil googly eye	spooky stuffing
toy crazy train	CRIMBO07	spooky length of string (2)	spooky wooden block (3)	spooky toy wheel (6)
toy mercenary	CRIMBO07	evil googly eye (2)	spooky wooden block (3)
tree-eating kite	CRIMBO07	spooky length of string	spooky felt
vampire duck-on-a-string	CRIMBO07	spooky length of string	evil googly eye (2)	spooky wooden block (2)	spooky toy wheel (2)


# Future Crimbo toys.  These are items which are created by Uncle Crimborg
# after collecting enough toy components.

atomic vector plotter	CRIMBO07	ion grid	Feynman gate
bi-lateral logic compressor	CRIMBO07	capacitor relay	Feynman gate
computronic processing unit	CRIMBO07	capacitor relay	logic synthesizer
hyperbolic plasma focuser	CRIMBO07	Feynman gate	logic synthesizer
ion-pulse modulation stabilizer	CRIMBO07	ion grid	logic synthesizer
quantum polarity inducer	CRIMBO07	capacitor relay	ion grid
recursive spline reticulator	CRIMBO07	carbon nanotube frame	logic synthesizer
reverse-oscillating klystron	CRIMBO07	carbon nanotube frame	ion grid
servomechanical torsion facilitator	CRIMBO07	capacitor relay	carbon nanotube frame
sub-molecular interocitor	CRIMBO07	carbon nanotube frame	Feynman gate

MagiMechTech NanoMechaMech	CRIMBO07	high-resistance ultrapolymer plating	computronic processing unit	sub-molecular interocitor
astronaut pants	CRIMBO07	high-resistance ultrapolymer plating	quantum polarity inducer	recursive spline reticulator
toy jet pack	CRIMBO07	high-resistance ultrapolymer plating	reverse-oscillating klystron	ion-pulse modulation stabilizer
toy ray gun	CRIMBO07	high-resistance ultrapolymer plating	servomechanical torsion facilitator	hyperbolic plasma focuser
toy space helmet	CRIMBO07	high-resistance ultrapolymer plating	bi-lateral logic compressor	atomic vector plotter

# Crimbo 08 items

wriggling tentacle	COMBINE	unstable DNA	pulsing flesh
mass of wriggling tentacles	COMBINE	wriggling tentacle	wriggling tentacle
pair of twitching claws	COMBINE	twitching claw	twitching claw
gnashing teeth	COMBINE	pair of twitching claws	unstable DNA
chitinous pod	COMBINE	rigid carapace	rigid carapace

parasitic claw	COMBINE	twitching claw	unstable DNA
parasitic tentacles	COMBINE	mass of wriggling tentacles	rigid carapace
parasitic headgnawer	COMBINE	gnashing teeth	rigid carapace
parasitic strangleworm	COMBINE	wriggling tentacle	rigid carapace

burrowgrub hive	COMBINE	chitinous pod	unstable DNA
pair of ragged claws	COMBINE	mass of wriggling tentacles	pair of twitching claws
